{
    "map" : {
        "name" : "TEST",
        "tile_atlas" : {
            "path" : "iso-64x64-outside.png",
            "tile_size": 64
        },
        "visual_grid" : [70, 70, 70, 70, 70, 70, 70, 70, 70, 70, 70, 70, 70, 70, 70, 70,
                         70, 1 , 1 , 1 , 1 , 1 , 1 , 1 , 1 , 1,  1 , 1 , 1 , 1 , 1 , 70, 
                         70, 1 , 1 , 1 , 1 , 1 , 1 , 1 , 1 , 1,  1 , 1 , 1 , 1 , 1 , 70, 
                         70, 1 , 1 , 1 , 1 , 1 , 1 , 1 , 1 , 1,  1 , 1 , 1 , 1 , 1 , 70, 
                         70, 1 , 1 , 1 , 1 , 1 , 1 , 1 , 1 , 1,  1 , 1 , 1 , 1 , 1 , 70, 
                         70, 70, 70, 70, 70, 70, 70, 70, 70, 70, 70, 70, 70, 70, 70, 70],
        "koment" : ["0 - free, 1 - sciana, 2 - gracz, 3 - box, 4 - win, 5 - box and win"],
        "logical_grid": [1, 1, 1, 1, 1, 1, 1, 1, 1, 1, 1, 1, 1, 1, 1, 1,
                         1, 2, 0, 3, 3, 0, 0, 0, 0, 0, 0, 0, 0, 0, 0, 1, 
                         1, 0, 0, 0, 3, 0, 0, 0, 3, 5, 0, 0, 0, 0, 0, 1, 
                         1, 0, 0, 0, 0, 0, 0, 0, 0, 0, 0, 0, 0, 0, 0, 1, 
                         1, 0, 0, 0, 0, 0, 0, 0, 0, 0, 0, 0, 0, 0, 0, 1, 
                         1, 1, 1, 1, 1, 1, 1, 1, 1, 1, 1, 1, 1, 1, 1, 1]
    }
}