{
    "map" : {
        "name" : "TEST",
        "width" : 16, 
        "tile_atlas" : {
            "path" : "iso-64x64-outside.png",
            "tile_size": 64,
            "columns" : 10,
            "rows" : 1,
            "visual_grid" : [70, 70, 70, 70, 70, 70, 70, 70, 70, 70, 70, 70, 70, 70, 70, 70,
                             70, 1 , 1 , 1 , 1 , 1 , 1 , 1 , 1 , 1,  1 , 1 , 1 , 1 , 1 , 70, 
                             70, 1 , 1 , 1 , 1 , 1 , 1 , 1 , 1 , 1,  1 , 1 , 1 , 1 , 1 , 70, 
                             70, 1 , 1 , 1 , 1 , 1 , 1 , 1 , 1 , 1,  1 , 1 , 1 , 1 , 1 , 70, 
                             70, 1 , 1 , 1 , 1 , 1 , 1 , 1 , 1 , 1,  1 , 1 , 1 , 1 , 1 , 70, 
                             70, 70, 70, 70, 70, 70, 70, 70, 70, 70, 70, 70, 70, 70, 70, 70],
            "koment" : ["0 - free, 1 - sciana, 2 - gracz, 3 - box, 4 - win, 5 - box and win"],
            "logical_grid": [1, 1, 1, 1, 1, 1, 1, 1, 1, 1, 1, 1, 1, 1, 1, 1,
                             1, 2, 0, 3, 3, 0, 0, 0, 0, 0, 0, 0, 0, 0, 0, 1, 
                             1, 0, 0, 0, 3, 0, 0, 0, 3, 5, 0, 0, 0, 0, 0, 1, 
                             1, 0, 0, 0, 0, 0, 0, 0, 0, 0, 0, 0, 0, 0, 0, 1, 
                             1, 0, 0, 0, 0, 0, 0, 0, 0, 0, 0, 0, 0, 0, 0, 1, 
                             1, 1, 1, 1, 1, 1, 1, 1, 1, 1, 1, 1, 1, 1, 1, 1]
           },
        "player_start" : [3, 2],
        "boxes_amount" : 3,
        "boxes_pos" : [[1, 1], [8, 2], [9, 2]]
    }
}