{
    "map" : {
        "name" : "Level 13",
        "tile_atlas" : {
            "path" : "res/graphics/tile_new.png",
            "tile_size": 64
        },
        "theme_song" : "res/sounds/level/level_5.wav",

        "visual_grid" : [55, 56, 86, 98, 98, 98, 98, 98, 98, 98, 98, 98, 98, 98, 98, 98,
                         55, 82, 86, 94, 98, 98, 98, 98, 94, 98, 98, 98, 98, 98, 98, 98,
                         55, 56, 86, 98, 98, 98, 98, 98, 98, 98, 98, 98, 98, 98, 94, 98,
                         55, 56, 68, 98, 98, 98, 98, 98, 98, 98, 98, 98, 99, 98, 98, 98,
                         55, 56, 88, 98, 43, 47, 43, 43, 44, 43, 98, 98, 98, 98, 98, 98,
                         55, 83, 86, 98, 43, 43, 43, 43, 92, 43, 98, 98, 98, 98, 98, 98,
                         55, 56, 86, 98, 44, 43, 43, 44, 43, 43, 98, 95, 98, 97, 98, 98,
                         80, 56, 86, 98, 98, 98, 98, 98, 98, 98, 98, 94, 98, 98, 98, 98,
                         55, 56, 68, 98, 94, 98, 98, 98, 98, 98, 98, 98, 98, 98, 98, 98,
                         55, 81, 86, 98, 98, 98, 98, 98, 98, 94, 98, 98, 99, 98, 98, 98,
                         55, 56, 86, 98, 98, 98, 98, 98, 98, 98, 98, 98, 98, 98, 98, 98],

        "logical_grid": [1, 1, 1, 1, 1, 1, 1, 1, 1, 1, 1, 1, 1, 1, 1, 1,
                         1, 1, 1, 1, 1, 1, 1, 1, 1, 1, 1, 1, 1, 1, 1, 1,
                         1, 1, 1, 1, 1, 1, 1, 1, 1, 1, 1, 1, 1, 1, 1, 1,
                         1, 1, 1, 1, 1, 1, 1, 1, 1, 1, 1, 1, 1, 1, 1, 1,
                         1, 1, 1, 1, 1, 0, 0, 0, 0, 0, 1, 1, 1, 1, 1, 1,
                         1, 1, 1, 1, 1, 2, 3, 0, 4, 0, 1, 1, 1, 1, 1, 1,
                         1, 1, 1, 1, 1, 0, 0, 0, 0, 0, 1, 1, 1, 1, 1, 1,
                         1, 1, 1, 1, 1, 1, 1, 1, 1, 1, 1, 1, 1, 1, 1, 1,
                         1, 1, 1, 1, 1, 1, 1, 1, 1, 1, 1, 1, 1, 1, 1, 1,
                         1, 1, 1, 1, 1, 1, 1, 1, 1, 1, 1, 1, 1, 1, 1, 1,
                         1, 1, 1, 1, 1, 1, 1, 1, 1, 1, 1, 1, 1, 1, 1, 1]
    }
}