{
    "map" : {
        "name" : "TEST",
        "tile_atlas" : {
            "path" : "tile_new.png",
            "tile_size": 64
        },
        "visual_grid" : [64, 50, 50, 50, 50, 50, 71, 65, 50, 50, 50, 71, 50, 50, 64, 50,
                         50, 50, 65, 50, 50, 50, 50, 50, 50, 64, 50, 50, 65, 71, 50, 70, 
                         50, 50, 50, 50 , 71 , 50 , 50 , 50 , 50 , 50 , 14 , 0 , 0 , 0 , 50, 71, 
                         50, 50, 50 , 50 , 50 , 65 , 50, 50 , 65 , 50 , 0 , 0 , 0 , 15 , 50, 50, 
                         50, 50, 71 , 50 , 50 , 50 , 50 , 50 , 50 , 50 , 54 , 0 , 0 , 0 , 50, 50, 
                         50, 64, 50 , 50 , 50 , 50 , 0 , 0 , 14 , 0 , 0 , 0 , 0 , 0 , 50, 64,
                         50, 50, 50 , 50 , 64 , 50 , 0 , 0 , 0 , 0 , 0 , 0 , 0 , 0 , 50, 65,
                         50, 50, 50 , 50 , 50 , 50 , 0 , 0 , 0 , 0 , 0 , 0 , 0 , 0 , 50, 50, 
                         50, 71, 50 , 50 , 50 , 50 , 54 , 0 , 0 , 0 , 0 , 21 , 0 , 0 , 71, 50, 
                         50, 50, 65, 50, 50, 50, 65, 50, 50, 64, 54, 0, 14, 0, 50, 50, 
                         50, 64, 50, 50, 50, 50, 50, 50, 64, 50, 50, 71, 50, 65, 50, 50,
                         50, 50, 50, 50, 50, 50, 50, 50, 64, 50, 50, 50, 50, 65, 50, 50],

        "koment" : ["0 - free, 1 - sciana, 2 - gracz, 3 - box, 4 - win, 5 - box and win"],
        "logical_grid": [1, 1, 1, 1, 1, 1, 1, 1, 1, 1, 1, 1, 1, 1, 1, 1,
                         1, 1, 1, 1, 1, 1, 1, 1, 1, 1, 1, 1, 1, 1, 1, 1, 
                         1, 1, 1, 1, 1, 1, 1, 1, 1, 1, 0, 0, 0, 2, 1, 1, 
                         1, 1, 1, 1, 1, 1, 1, 1, 1, 1, 0, 3, 0, 0, 1, 1, 
                         1, 1, 1, 1, 1, 1, 1, 1, 1, 1, 4, 0, 0, 0, 1, 1, 
                         1, 1, 1, 1, 1, 1, 0, 3, 0, 0, 0, 0, 0, 0, 1, 0,
                         1, 1, 1, 1, 1, 1, 0, 0, 0, 0, 0, 0, 0, 0, 1, 1, 
                         1, 1, 1, 1, 1, 1, 0, 0, 3, 0, 0, 0, 0, 0, 1, 1, 
                         1, 1, 1, 1, 1, 1, 4, 0, 0, 0, 0, 0, 0, 0, 1, 1, 
                         1, 1, 1, 1, 1, 1, 1, 1, 1, 4, 0, 0, 0, 0, 1, 1, 
                         1, 1, 1, 1, 1, 1, 1, 1, 1, 1, 1, 1, 1, 1, 1, 1,
                         1, 1, 1, 1, 1, 1, 1, 1, 1, 1, 1, 1, 1, 1, 1, 1]
    }
}