{
    "map" : {
        "name" : "Level 16",
        "tile_atlas" : {
            "path" : "res/graphics/tile_new.png",
            "tile_size": 64
        },
        "theme_song" : "res/sounds/level/level_5.wav",

        "visual_grid" : [59, 59, 76, 59, 59, 59, 77, 59, 78, 59, 59, 59, 77, 59, 76, 59,
                         79, 58, 58, 58, 58, 58, 58, 58, 58, 58, 58, 58, 58, 58, 58, 58,
                         58, 58, 58, 58, 58, 58, 58,  8,  8,  8, 75, 58, 58, 58, 58, 58,
                         58, 58, 58, 58, 58, 91,  8,  8, 25,  8, 58, 58, 58, 58, 58, 58,
                         58, 74, 58, 58, 58, 58, 58,  8,  8, 91, 58, 58, 58, 58, 72, 58,
                         58, 58, 58, 58, 58, 91, 58, 58,  8,  8, 58, 58, 58, 58, 58, 58,
                         58, 58, 58, 58, 79,  8, 58,  8, 91,  8, 58, 58, 58, 58, 58, 58,
                         58, 58, 58, 58, 58,  8,  8, 91, 23,  8, 91, 58, 58, 58, 58, 58,
                         58, 58, 72, 58, 58, 29,  8,  8, 91,  8,  8, 58, 58, 58, 58, 58,
                         58, 58, 58, 58, 58, 58, 58, 58, 58, 58, 58, 58, 79, 58, 58, 58,
                         58, 58, 58, 58, 58, 58, 58, 58, 58, 58, 58, 58, 58, 58, 58, 58,
                         58, 58, 58, 58, 58, 58, 58, 58, 58, 58, 58, 58, 58, 58, 58, 58],
        
        "logical_grid": [1, 1, 1, 1, 1, 1, 1, 1, 1, 1, 1, 1, 1, 1, 1, 1,
                         1, 1, 1, 1, 1, 1, 1, 1, 1, 1, 1, 1, 1, 1, 1, 1, 
                         1, 1, 1, 1, 1, 1, 1, 0, 0, 0, 1, 1, 1, 1, 1, 1, 
                         1, 1, 1, 1, 1, 4, 2, 3, 0, 0, 1, 1, 1, 1, 1, 1, 
                         1, 1, 1, 1, 1, 1, 1, 0, 3, 4, 1, 1, 1, 1, 1, 1, 
                         1, 1, 1, 1, 1, 4, 1, 1, 3, 0, 1, 1, 1, 1, 1, 1,
                         1, 1, 1, 1, 1, 0, 1, 0, 4, 0, 1, 1, 1, 1, 1, 1,
                         1, 1, 1, 1, 1, 3, 0, 5, 3, 3, 4, 1, 1, 1, 1, 1,
                         1, 1, 1, 1, 1, 0, 0, 0, 4, 0, 0, 1, 1, 1, 1, 1,
                         1, 1, 1, 1, 1, 1, 1, 1, 1, 1, 1, 1, 1, 1, 1, 1,
                         1, 1, 1, 1, 1, 1, 1, 1, 1, 1, 1, 1, 1, 1, 1, 1,
                         1, 1, 1, 1, 1, 1, 1, 1, 1, 1, 1, 1, 1, 1, 1, 1]
    }
}