{
    "map" : {
        "name" : "Level 18",
        "tile_atlas" : {
            "path" : "res/graphics/tile_new.png",
            "tile_size": 64
        },
        "theme_song" : "res/sounds/level/level_3.wav",
        
        "visual_grid" : [52, 52, 52, 52, 52, 52, 52, 52, 52, 52, 52, 52, 52, 51, 51, 51,
                         52, 52, 52, 52, 52,  2,  2,  2, 52, 63, 52, 52, 52, 51, 51, 51,
                         52, 90,  2,  2, 52,  2,  2,  2, 52,  2,  2, 52, 52, 51, 60, 51,
                         52,  2,  2,  2,  2,  2,  2,  2, 13,  2,  2, 52, 52, 51, 51, 51,
                         52,  2,  2, 12,  2, 62,  2,  2,  2, 52,  2, 52, 52, 51, 51, 51,
                         52, 52, 52, 52,  2, 52,  2,  2,  2, 52,  2, 52, 52, 51, 61, 51,
                         52, 52, 52,  2,  2, 52, 52, 52, 52, 52,  2, 52, 52, 51, 70, 51,
                         52, 52, 90,  2,  2,  2, 90, 90,  2,  2, 90, 52, 52, 61, 51, 51,
                         52, 52, 62, 52, 52, 52, 52, 52, 52, 52, 52, 52, 52, 51, 51, 51,
                         52, 52, 52, 52, 52, 52, 52, 52, 52, 52, 63, 52, 52, 51, 60, 51,
                         52, 52, 52, 52, 52, 52, 52, 52, 52, 52, 52, 52, 52, 51, 51, 51,
                         52, 52, 52, 52, 52, 52, 52, 52, 52, 52, 52, 52, 52, 51, 51, 51],

        "logic_grid"  : [1, 1, 1, 1, 1, 1, 1, 1, 1, 1, 1, 1, 1, 1, 1, 1,
                         1, 1, 1, 1, 1, 0, 0, 0, 1, 1, 1, 1, 1, 1, 1, 1, 
                         1, 4, 0, 0, 1, 3, 0, 0, 1, 0, 0, 1, 1, 1, 1, 1, 
                         1, 2, 0, 3, 3, 0, 0, 0, 0, 0, 0, 1, 1, 1, 1, 1,
                         1, 0, 0, 0, 0, 1, 3, 3, 0, 1, 0, 1, 1, 1, 1, 1,
                         1, 1, 1, 1, 0, 1, 0, 0, 0, 1, 0, 1, 1, 1, 1, 1,
                         1, 1, 1, 0, 0, 1, 1, 1, 1, 1, 0, 1, 1, 1, 1, 1,
                         1, 1, 4, 0, 0, 0, 4, 4, 0, 0, 4, 1, 1, 1, 1, 1,
                         1, 1, 1, 1, 1, 1, 1, 1, 1, 1, 1, 1, 1, 1, 1, 1,
                         1, 1, 1, 1, 1, 1, 1, 1, 1, 1, 1, 1, 1, 1, 1, 1,
                         1, 1, 1, 1, 1, 1, 1, 1, 1, 1, 1, 1, 1, 1, 1, 1,
                         1, 1, 1, 1, 1, 1, 1, 1, 1, 1, 1, 1, 1, 1, 1, 1]
    }
}