{
    "map" : {
        "name" : "Level 11",
        "tile_atlas" : {
            "path" : "res/graphics/tile_new.png",
            "tile_size": 64
        },
        "theme_song" : "res/sounds/level/level_6.wav",

        "visual_grid" : [55, 56, 86, 98, 98, 98, 98, 98, 98, 98, 98, 98, 98, 98, 98, 98,
                         55, 82, 86, 94, 98, 98, 98, 98, 94, 98, 98, 98, 98, 98, 98, 98,
                         55, 56, 86, 98, 98, 98, 98, 98, 98, 98, 98, 98, 98, 98, 94, 98,
                         55, 56, 68, 98, 98, 43, 43, 98, 98, 92, 98, 98, 99, 98, 98, 98,
                         55, 56, 88, 98, 98, 47, 43, 43, 44, 43, 98, 98, 98, 98, 98, 98,
                         55, 83, 86, 98, 98, 43, 43, 98, 98, 43, 98, 98, 98, 98, 98, 98,
                         55, 56, 86, 98, 98, 43, 43, 44, 43, 43, 98, 95, 98, 97, 98, 98,
                         80, 56, 86, 98, 98, 92, 98, 98, 98, 98, 98, 94, 98, 98, 98, 98,
                         55, 56, 68, 98, 94, 98, 98, 98, 98, 98, 98, 98, 98, 98, 98, 98,
                         55, 81, 86, 98, 98, 98, 98, 98, 98, 94, 98, 98, 99, 98, 98, 98,
                         55, 56, 86, 98, 98, 98, 98, 98, 98, 98, 98, 98, 98, 98, 98, 98,
                         55, 56, 86, 98, 98, 98, 98, 98, 98, 98, 98, 98, 98, 98, 98, 98],

        "logic_grid"  : [1, 1, 1, 1, 1, 1, 1, 1, 1, 1, 1, 1, 1, 1, 1, 1,
                         1, 1, 1, 1, 1, 1, 1, 1, 1, 1, 1, 1, 1, 1, 1, 1,
                         1, 1, 1, 1, 1, 1, 1, 1, 1, 1, 1, 1, 1, 1, 1, 1,
                         1, 1, 1, 1, 1, 0, 0, 1, 1, 4, 1, 1, 1, 1, 1, 1,
                         1, 1, 1, 1, 1, 0, 3, 0, 0, 0, 1, 1, 1, 1, 1, 1,
                         1, 1, 1, 1, 1, 2, 3, 1, 1, 0, 1, 1, 1, 1, 1, 1,
                         1, 1, 1, 1, 1, 0, 0, 0, 0, 0, 1, 1, 1, 1, 1, 1,
                         1, 1, 1, 1, 1, 4, 1, 1, 1, 1, 1, 1, 1, 1, 1, 1,
                         1, 1, 1, 1, 1, 1, 1, 1, 1, 1, 1, 1, 1, 1, 1, 1,
                         1, 1, 1, 1, 1, 1, 1, 1, 1, 1, 1, 1, 1, 1, 1, 1,
                         1, 1, 1, 1, 1, 1, 1, 1, 1, 1, 1, 1, 1, 1, 1, 1,
                         1, 1, 1, 1, 1, 1, 1, 1, 1, 1, 1, 1, 1, 1, 1, 1]
    }
}