{
    "map" : {
        "name" : "Level 17",
        "tile_atlas" : {
            "path" : "res/graphics/tile_new.png",
            "tile_size": 64
        },
        "theme_song" : "res/sounds/level/level_2.wav",

        "visual_grid" : [59, 59, 76, 59, 59, 59, 77, 59, 78, 59, 59, 59, 77, 59, 76, 59,
                         79, 58, 58, 58, 58, 58, 58, 58, 58, 58, 58, 58, 58, 58, 58, 58,
                         58, 58, 58, 58,  8,  8, 58,  8,  8,  8, 75, 58, 58, 58, 58, 58,
                         58, 58, 58, 58,  8, 24,  8,  8,  8,  8, 58, 58, 58, 58, 58, 58,
                         58, 74, 58, 58,  8,  8, 58,  8,  8,  8, 58, 58, 58, 58, 72, 58,
                         58, 58, 58, 58, 58,  8, 58,  8,  8,  8, 58, 58, 58, 58, 58, 58,
                         58, 58, 58, 58, 91, 91,  8,  8, 58, 25, 58, 58, 58, 58, 58, 58,
                         58, 58, 58, 58, 91, 91,  8, 24,  8,  8, 58, 58, 58, 58, 58, 58,
                         58, 58, 72, 58, 58, 58, 58, 58, 58, 58, 58, 58, 58, 58, 58, 58,
                         58, 58, 58, 58, 58, 58, 58, 58, 58, 58, 58, 58, 79, 58, 58, 58,
                         58, 58, 58, 58, 58, 58, 58, 58, 58, 58, 58, 58, 58, 58, 58, 58,
                         58, 58, 58, 58, 58, 58, 58, 58, 58, 58, 58, 58, 58, 58, 58, 58],
        
        "logic_grid"  : [1, 1, 1, 1, 1, 1, 1, 1, 1, 1, 1, 1, 1, 1, 1, 1,
                         1, 1, 1, 1, 1, 1, 1, 1, 1, 1, 1, 1, 1, 1, 1, 1, 
                         1, 1, 1, 1, 0, 0, 1, 0, 0, 0, 1, 1, 1, 1, 1, 1, 
                         1, 1, 1, 1, 0, 0, 0, 3, 0, 0, 1, 1, 1, 1, 1, 1, 
                         1, 1, 1, 1, 0, 0, 1, 3, 3, 0, 1, 1, 1, 1, 1, 1, 
                         1, 1, 1, 1, 1, 0, 1, 0, 0, 0, 1, 1, 1, 1, 1, 1,
                         1, 1, 1, 1, 4, 4, 0, 3, 1, 0, 1, 1, 1, 1, 1, 1,
                         1, 1, 1, 1, 4, 4, 0, 0, 0, 2, 1, 1, 1, 1, 1, 1,
                         1, 1, 1, 1, 1, 1, 1, 1, 1, 1, 1, 1, 1, 1, 1, 1,
                         1, 1, 1, 1, 1, 1, 1, 1, 1, 1, 1, 1, 1, 1, 1, 1,
                         1, 1, 1, 1, 1, 1, 1, 1, 1, 1, 1, 1, 1, 1, 1, 1,
                         1, 1, 1, 1, 1, 1, 1, 1, 1, 1, 1, 1, 1, 1, 1, 1]
    }
}