{
    "map" : {
        "name" : "Level 11",
        "tile_atlas" : {
            "path" : "res/graphics/tile_new.png",
            "tile_size": 64
        },
        "theme_song" : "res/sounds/level/level_4.wav",

        "visual_grid" : [56, 56, 56, 56, 56, 56, 56, 55, 56, 56, 56, 56, 56, 56, 56, 88,
                         56, 56, 56, 56, 56, 56, 83, 55, 56, 56, 56, 56, 56, 56, 56, 86,
                         56, 56, 93 , 6 , 56, 56, 56, 55, 56, 56, 56, 56, 56, 56, 56, 86,
                         56, 56, 6 , 6,  6 , 6 , 6 , 5 , 6 ,  6, 56, 56, 56, 56, 56, 86,
                         56, 56, 6 , 6 , 56, 6 , 6 , 5 , 6 ,  6, 56, 56, 56, 56, 56, 86,
                         56, 56, 6 , 56, 93, 93, 93, 5 , 93, 93, 56, 56, 56, 56, 56, 86,
                         56, 56, 6, 6 , 56, 6 , 6 , 5 , 6 ,  6, 56, 56, 56, 56, 56, 86,
                         56, 56, 56, 6 , 56, 81, 56, 55, 6 , 56, 62, 56, 56, 56, 56, 86,
                         56, 56, 93 , 6 , 6,  6,  6,  5,  6,  6,  56, 56, 56, 56, 56, 86,
                         56, 56, 31, 6 , 6,  56, 56, 5,  6,  6,  56, 56, 81, 56, 56, 86,
                         56, 56, 56, 56, 56, 56, 56, 55, 56, 56, 56, 56, 56, 56, 56, 86,
                         56, 56, 56, 56, 56, 56, 56, 56, 56, 56, 56, 56, 56, 56, 56, 86],

        "logic_grid"  : [1, 1, 1, 1, 1, 1, 1, 1, 1, 1, 1, 1, 1, 1, 1, 1,
                         1, 1, 1, 1, 1, 1, 1, 1, 1, 1, 1, 1, 1, 1, 1, 1, 
                         1, 1, 4, 0, 1, 1, 1, 1, 1, 1, 1, 1, 1, 1, 1, 1, 
                         1, 1, 0, 0, 3, 0, 0, 0, 0, 0, 1, 1, 1, 1, 1, 1,
                         1, 1, 0, 0, 1, 3, 3, 0, 0, 3, 1, 1, 1, 1, 1, 1,
                         1, 1, 0, 1, 4, 4, 4, 3, 5, 4, 1, 1, 1, 1, 1, 1,
                         1, 1, 4, 0, 1, 0, 0, 0, 0, 0, 1, 1, 1, 1, 1, 1,
                         1, 1, 1, 3, 1, 1, 1, 1, 0, 1, 1, 1, 1, 1, 1, 1,
                         1, 1, 4, 0, 0, 0, 0, 0, 0, 0, 1, 1, 1, 1, 1, 1,
                         1, 1, 0, 0, 0, 1, 1, 0, 2, 0, 1, 1, 1, 1, 1, 1,
                         1, 1, 1, 1, 1, 1, 1, 1, 1, 1, 1, 1, 1, 1, 1, 1,
                         1, 1, 1, 1, 1, 1, 1, 1, 1, 1, 1, 1, 1, 1, 1, 1]
    }
}