{
    "map" : {
        "name" : "Level 14",
        "tile_atlas" : {
            "path" : "res/graphics/tile_new.png",
            "tile_size": 64
        },
        "theme_song" : "res/sounds/level/level_1.wav",

        "visual_grid" : [59, 59, 76, 59, 59, 59, 77, 59, 78, 59, 59, 59, 77, 59, 76, 59,
                         79, 58, 58, 58, 58, 58, 58, 58, 58, 58, 58, 58, 58, 58, 58, 58,
                         58, 58, 58, 58,  8,  8, 58, 58, 58, 58, 75, 58, 58, 58, 58, 58,
                         58, 58,  8,  8,  8, 24,  8,  8,  8, 58, 58, 58, 58, 58, 58, 58,
                         58, 74,  8, 58,  8,  8, 58,  8,  8, 58, 58, 58, 58, 58, 72, 58,
                         58, 58,  8, 91,  8, 91, 58,  8,  8, 58, 58, 58, 58, 58, 58, 58,
                         58, 58, 58, 58, 79, 58, 58, 58, 58, 75, 58, 58, 58, 58, 58, 58,
                         58, 58, 58, 58, 58, 58, 58, 58, 58, 58, 58, 58, 58, 58, 58, 58,
                         58, 58, 72, 58, 58, 58, 58, 58, 58, 58, 58, 58, 58, 58, 58, 58,
                         58, 58, 58, 58, 58, 58, 58, 58, 58, 58, 58, 58, 79, 58, 58, 58,
                         58, 58, 58, 58, 58, 58, 58, 58, 58, 58, 58, 58, 58, 58, 58, 58,
                         58, 58, 58, 58, 58, 58, 58, 58, 58, 58, 58, 58, 58, 58, 58, 58],

        "logic_grid"  : [1, 1, 1, 1, 1, 1, 1, 1, 1, 1, 1, 1, 1, 1, 1, 1,
                         1, 1, 1, 1, 1, 1, 1, 1, 1, 1, 1, 1, 1, 1, 1, 1, 
                         1, 1, 1, 1, 0, 0, 1, 1, 1, 1, 1, 1, 1, 1, 1, 1, 
                         1, 1, 0, 0, 0, 0, 0, 3, 0, 1, 1, 1, 1, 1, 1, 1, 
                         1, 1, 0, 1, 0, 0, 1, 3, 0, 1, 1, 1, 1, 1, 1, 1, 
                         1, 1, 0, 4, 0, 4, 1, 2, 0, 1, 1, 1, 1, 1, 1, 1,
                         1, 1, 1, 1, 1, 1, 1, 1, 1, 1, 1, 1, 1, 1, 1, 1,
                         1, 1, 1, 1, 1, 1, 1, 1, 1, 1, 1, 1, 1, 1, 1, 1,
                         1, 1, 1, 1, 1, 1, 1, 1, 1, 1, 1, 1, 1, 1, 1, 1,
                         1, 1, 1, 1, 1, 1, 1, 1, 1, 1, 1, 1, 1, 1, 1, 1,
                         1, 1, 1, 1, 1, 1, 1, 1, 1, 1, 1, 1, 1, 1, 1, 1,
                         1, 1, 1, 1, 1, 1, 1, 1, 1, 1, 1, 1, 1, 1, 1, 1]
    }
}