{
    "map" : {
        "name" : "Level 20",
        "tile_atlas" : {
            "path" : "res/graphics/tile_new.png",
            "tile_size": 64
        },
        "theme_song" : "res/sounds/level/level_3.wav",
        "visual_grid" : [59, 59, 76, 59, 59, 59, 77, 59, 78, 59, 59, 59, 77, 59, 76, 59,
                         79, 58, 58, 58, 58, 58, 58, 58, 58, 58, 58, 58, 58, 58, 58, 58,
                         58, 58, 58, 58, 58, 58, 58, 58, 58, 58, 75, 58, 58, 58, 58, 58,
                         58, 58, 58, 58, 58, 74, 23, 91, 58, 58, 58, 58, 58, 58, 58, 58,
                         58, 74, 58, 58, 58, 58, 91,  8,  8,  8, 29, 58, 58, 58, 72, 58,
                         58, 58, 58, 58, 58, 91, 91,  8, 58, 58,  8, 58, 58, 58, 58, 58,
                         58, 58, 58, 58, 79,  8, 58,  8, 58, 75,  8, 58, 58, 58, 58, 58,
                         58, 58, 58, 58, 58,  8, 25,  8,  8, 39,  8, 58, 58, 58, 58, 58,
                         58, 58, 72, 58, 58, 58,  8,  8,  8, 58, 58, 58, 58, 58, 58, 58,
                         58, 58, 58, 58, 58, 58,  8,  8,  8, 58, 58, 58, 79, 58, 58, 58,
                         58, 58, 58, 58, 58, 58, 58, 58, 58, 58, 58, 58, 58, 58, 58, 58,
                         58, 58, 58, 58, 58, 58, 58, 58, 58, 58, 58, 58, 58, 58, 58, 58],

        "logical_grid": [1, 1, 1, 1, 1, 1, 1, 1, 1, 1, 1, 1, 1, 1, 1, 1,
                         1, 1, 1, 1, 1, 1, 1, 1, 1, 1, 1, 1, 1, 1, 1, 1, 
                         1, 1, 1, 1, 1, 1, 1, 1, 1, 1, 1, 1, 1, 1, 1, 1, 
                         1, 1, 1, 1, 1, 1, 0, 4, 1, 1, 1, 1, 1, 1, 1, 1, 
                         1, 1, 1, 1, 1, 1, 4, 0, 0, 0, 0, 1, 1, 1, 1, 1, 
                         1, 1, 1, 1, 1, 4, 4, 0, 1, 1, 0, 1, 1, 1, 1, 1,
                         1, 1, 1, 1, 1, 0, 1, 0, 1, 1, 0, 1, 1, 1, 1, 1,
                         1, 1, 1, 1, 1, 0, 3, 0, 0, 3, 0, 1, 1, 1, 1, 1,
                         1, 1, 1, 1, 1, 1, 0, 3, 3, 1, 1, 1, 1, 1, 1, 1,
                         1, 1, 1, 1, 1, 1, 2, 0, 0, 1, 1, 1, 1, 1, 1, 1,
                         1, 1, 1, 1, 1, 1, 1, 1, 1, 1, 1, 1, 1, 1, 1, 1,
                         1, 1, 1, 1, 1, 1, 1, 1, 1, 1, 1, 1, 1, 1, 1, 1]
    }
}