{
    "map" : {
        "name" : "Level 4",
        "tile_atlas" : {
            "path" : "res/graphics/tile_new.png",
            "tile_size": 64
        },
        "theme_song" : "res/sounds/level/level_3.wav",

        "visual_grid" : [55, 56, 50, 50, 50, 50, 50, 50, 50, 50, 50, 50, 50, 50, 50, 50,
                         55, 56, 50, 50, 50, 50, 50, 50, 50, 50, 50, 50, 50, 65, 50, 50,
                         55, 56, 50, 50, 50, 50, 50, 50, 50, 50, 50, 50, 50, 50, 50, 50,
                         55, 56, 50, 50, 50,  0,  0, 50,  0, 14,  0, 50, 50, 50, 50, 50,
                         55, 56, 50, 71, 50,  0,  0,  0,  0,  0,  0, 50, 50, 50, 50, 50,
                         55, 56, 50, 50, 50,  0, 21,  0,  0,  0,  0, 50, 50, 50, 71, 50,
                         55, 56, 50, 50, 50,  0,  0, 54, 54, 54,  0, 50, 50, 50, 50, 50,
                         55, 56, 50, 50, 50,  0,  0, 50, 50, 50, 50, 50, 50, 50, 50, 50,
                         55, 56, 50, 50, 50, 50, 50, 50, 50, 50, 50, 50, 65, 50, 50, 50,
                         55, 56, 50, 50, 64, 50, 50, 50, 50, 50, 50, 50, 50, 50, 50, 50,
                         55, 56, 50, 50, 50, 50, 50, 50, 50, 50, 50, 71, 50, 50, 50, 50,
                         55, 56, 50, 50, 50, 50, 50, 50, 50, 50, 50, 50, 50, 50, 50, 50],

        "logic_grid"  : [1, 1, 1, 1, 1, 1, 1, 1, 1, 1, 1, 1, 1, 1, 1, 1,
                         1, 1, 1, 1, 1, 1, 1, 1, 1, 1, 1, 1, 1, 1, 1, 1,
                         1, 1, 1, 1, 1, 1, 1, 1, 1, 1, 1, 1, 1, 1, 1, 1,
                         1, 1, 1, 1, 1, 0, 0, 1, 0, 0, 0, 1, 1, 1, 1, 1,
                         1, 1, 1, 1, 1, 2, 0, 3, 0, 3, 0, 1, 1, 1, 1, 1,
                         1, 1, 1, 1, 1, 0, 0, 3, 0, 0, 0, 1, 1, 1, 1, 1,
                         1, 1, 1, 1, 1, 0, 0, 4, 4, 4, 0, 1, 1, 1, 1, 1,
                         1, 1, 1, 1, 1, 0, 0, 1, 1, 1, 1, 1, 1, 1, 1, 1,
                         1, 1, 1, 1, 1, 1, 1, 1, 1, 1, 1, 1, 1, 1, 1, 1,
                         1, 1, 1, 1, 1, 1, 1, 1, 1, 1, 1, 1, 1, 1, 1, 1,
                         1, 1, 1, 1, 1, 1, 1, 1, 1, 1, 1, 1, 1, 1, 1, 1,
                         1, 1, 1, 1, 1, 1, 1, 1, 1, 1, 1, 1, 1, 1, 1, 1]
    }
}