{
    "map" : {
        "name" : "Level 4",
        "tile_atlas" : {
            "path" : "res/graphics/tile_new.png",
            "tile_size": 64
        },
        "theme_song" : "res/sounds/level/level_5.wav",

        "visual_grid" : [94, 99, 98, 98, 98, 99, 95, 98, 98, 99, 98, 98, 98, 98, 98, 96,
                         98, 98, 98, 98, 98, 98, 98, 98, 94, 98, 98, 94, 98, 97, 98, 98, 
                         98, 98, 98, 98, 44, 43, 40, 98, 98, 98, 98, 98, 98, 98, 98, 98, 
                         98, 98, 41, 42, 43, 44, 45, 92, 41, 41, 42, 98, 98, 98, 98, 97,  
                         98, 98, 47, 42, 43, 41, 43, 94, 43, 42, 49, 98, 99, 98, 98, 98,  
                         94, 98, 41, 42, 98, 41, 42, 98, 44, 41, 43, 98, 98, 98, 98, 98, 
                         98, 98, 44, 42, 43, 41, 92, 98, 41, 42, 41, 98, 98, 98, 94, 98, 
                         98, 95, 98, 92, 43, 98, 98, 98, 98, 98, 98, 98, 98, 98, 98, 98, 
                         98, 98, 98, 98, 98, 98, 98, 94, 98, 98, 98, 98, 98, 97, 94, 98, 
                         87, 87, 87, 69, 87, 87, 87, 87, 87, 87, 87, 87, 87, 87, 69, 87, 
                         56, 56, 56, 56, 56, 56, 56, 81, 56, 56, 56, 56, 56, 56, 56, 56],

        "logical_grid": [1, 1, 1, 1, 1, 1, 1, 1, 1, 1, 1, 1, 1, 1, 1, 1,
                         1, 1, 1, 1, 1, 1, 1, 1, 1, 1, 1, 1, 1, 1, 1, 1, 
                         1, 1, 1, 1, 0, 0, 0, 1, 1, 1, 1, 1, 1, 1, 1, 1, 
                         1, 1, 0, 0, 3, 0, 0, 5, 0, 0, 0, 1, 1, 1, 1, 1,
                         1, 1, 0, 0, 0, 0, 0, 1, 3, 0, 0, 1, 1, 1, 1, 1,
                         1, 1, 0, 0, 1, 0, 0, 1, 0, 0, 0, 1, 1, 1, 1, 1,
                         1, 1, 0, 0, 0, 0, 4, 1, 2, 0, 0, 1, 1, 1, 1, 1,
                         1, 1, 1, 4, 0, 1, 1, 1, 1, 1, 1, 1, 1, 1, 1, 1, 
                         1, 1, 1, 1, 1, 1, 1, 1, 1, 1, 1, 1, 1, 1, 1, 1,
                         1, 1, 1, 1, 1, 1, 1, 1, 1, 1, 1, 1, 1, 1, 1, 1,
                         1, 1, 1, 1, 1, 1, 1, 1, 1, 1, 1, 1, 1, 1, 1, 1]
    }
}