{
    "map" : {
        "name" : "Level 5",
        "tile_atlas" : {
            "path" : "res/graphics/tile_new.png",
            "tile_size": 64
        },
        "theme_song" : "res/sounds/level/level_6.wav",

        "visual_grid" : [94, 99, 98, 98, 98, 99, 95, 98, 98, 99, 98, 98, 98, 85, 56, 55,
                         98, 98, 98, 98, 98, 98, 98, 98, 94, 98, 98, 94, 98, 85, 83, 55, 
                         98, 98, 41, 43, 42, 43, 98, 43, 44, 41, 98, 98, 98, 85, 56, 55, 
                         98, 98, 41, 42, 43, 44, 42, 41, 98, 41, 98, 98, 98, 85, 56, 80,  
                         98, 98, 47, 42, 92, 41, 43, 42, 92, 42, 94, 98, 99, 85, 56, 55,  
                         94, 98, 41, 42, 98, 98, 92, 98, 42, 98, 98, 98, 98, 85, 56, 55, 
                         98, 98, 44, 42, 43, 44, 43, 41, 41, 97, 94, 98, 98, 85, 56, 55, 
                         98, 95, 41, 41, 44, 41, 44, 42, 41, 41, 92, 98, 98, 85, 82, 55, 
                         98, 98, 98, 98, 98, 98, 98, 98, 98, 98, 95, 98, 98, 85, 56, 55, 
                         98, 98, 95, 98, 98, 98, 97, 94, 98, 98, 98, 98, 98, 85, 56, 55, 
                         98, 98, 98, 98, 98, 98, 98, 98, 98, 98, 98, 94, 98, 85, 81, 55,
                         98, 98, 98, 98, 94, 98, 98, 98, 98, 98, 98, 98, 98, 85, 81, 55],

        "logical_grid": [1, 1, 1, 1, 1, 1, 1, 1, 1, 1, 1, 1, 1, 1, 1, 1,
                         1, 1, 1, 1, 1, 1, 1, 1, 1, 1, 1, 1, 1, 1, 1, 1, 
                         1, 1, 0, 0, 0, 0, 1, 0, 0, 2, 1, 1, 1, 1, 1, 1, 
                         1, 1, 0, 0, 0, 0, 0, 3, 1, 0, 1, 1, 1, 1, 1, 1,
                         1, 1, 0, 0, 4, 3, 3, 0, 4, 0, 1, 1, 1, 1, 1, 1,
                         1, 1, 0, 0, 0, 1, 4, 1, 3, 1, 1, 1, 1, 1, 1, 1,
                         1, 1, 0, 0, 0, 0, 0, 0, 0, 1, 1, 1, 1, 1, 1, 1,
                         1, 1, 0, 0, 0, 0, 4, 0, 0, 0, 4, 1, 1, 1, 1, 1, 
                         1, 1, 1, 1, 1, 1, 1, 1, 1, 1, 1, 1, 1, 1, 1, 1,
                         1, 1, 1, 1, 1, 1, 1, 1, 1, 1, 1, 1, 1, 1, 1, 1,
                         1, 1, 1, 1, 1, 1, 1, 1, 1, 1, 1, 1, 1, 1, 1, 1,
                         1, 1, 1, 1, 1, 1, 1, 1, 1, 1, 1, 1, 1, 1, 1, 1]
    }
}