{
    "map" : {
        "name" : "Level 9",
        "tile_atlas" : {
            "path" : "res/graphics/tile_new.png",
            "tile_size": 64
        },
        "theme_song" : "res/sounds/level/level_5.wav",

        "visual_grid" : [55, 56, 50, 50, 50, 50, 50, 50, 50, 50, 50, 50, 50, 50, 50, 50,
                         55, 56, 50, 50, 50, 50, 50, 50, 50, 50, 50, 50, 50, 50, 50, 50,
                         55, 56, 50, 54,  0,  0, 54,  0,  0,  0,  0,  0, 50, 50, 50, 50,
                         55, 56, 50,  0,  0, 50, 50,  50, 50,  0, 50,  0, 50, 50, 50, 50,
                         55, 56, 50,  0,  0,  0,  0,  0,  0,  0,  0,  0, 50, 50, 50, 50,
                         55, 56, 50,  0,  0,  0,  0, 54, 50,  0,  0,  0, 50, 50, 50, 50,
                         55, 56, 50, 50, 54, 50, 50, 50, 50, 50, 50, 50, 50, 50, 50, 50,
                         55, 56, 50, 50, 50, 50, 50, 50, 50, 50, 50, 50, 50, 50, 50, 50,
                         55, 56, 50, 50, 50, 50, 50, 50, 50, 50, 50, 50, 50, 50, 50, 50,
                         55, 56, 50, 50, 50, 50, 50, 50, 50, 50, 50, 50, 50, 50, 50, 50,
                         55, 56, 50, 50, 50, 50, 50, 50, 50, 50, 50, 50, 50, 50, 50, 50,
                         55, 56, 50, 50, 50, 50, 50, 50, 50, 50, 50, 50, 50, 50, 50, 50],

        "logical_grid": [1, 1, 1, 1, 1, 1, 1, 1, 1, 1, 1, 1, 1, 1, 1, 1,
                         1, 1, 1, 1, 1, 1, 1, 1, 1, 1, 1, 1, 1, 1, 1, 1,
                         1, 1, 1, 4, 0, 0, 5, 0, 0, 0, 3, 0, 1, 1, 1, 1,
                         1, 1, 1, 0, 3, 1, 1, 1, 1, 0, 1, 0, 1, 1, 1, 1,
                         1, 1, 1, 0, 0, 0, 0, 3, 0, 0, 0, 0, 1, 1, 1, 1,
                         1, 1, 1, 2, 0, 0, 0, 4, 1, 0, 0, 0, 1, 1, 1, 1,
                         1, 1, 1, 1, 4, 1, 1, 1, 1, 1, 1, 1, 1, 1, 1, 1,
                         1, 1, 1, 1, 1, 1, 1, 1, 1, 1, 1, 1, 1, 1, 1, 1,
                         1, 1, 1, 1, 1, 1, 1, 1, 1, 1, 1, 1, 1, 1, 1, 1,
                         1, 1, 1, 1, 1, 1, 1, 1, 1, 1, 1, 1, 1, 1, 1, 1,
                         1, 1, 1, 1, 1, 1, 1, 1, 1, 1, 1, 1, 1, 1, 1, 1,
                         1, 1, 1, 1, 1, 1, 1, 1, 1, 1, 1, 1, 1, 1, 1, 1]
    }
}