{
    "info" : ["0 - free, 1 - wall, 2 - player, 3 - box, 4 - win, 5 - box and win"],
    "map" : {
        "name" : "TEST",
        "zoom" : 1.0,
        "tile_atlas" : {
            "path" : "iso-64x64-outside.png",
            "tile_size": 64
        },
        "visual_grid" : [70, 70, 70, 70, 70, 70, 70, 70, 70, 70, 70, 70, 70, 70, 70, 70,
                         70, 1 , 1 , 1 , 1 , 1 , 1 , 1 , 1 , 1,  1 , 1 , 1 , 1 , 1 , 70, 
                         70, 1 , 1 , 1 , 1 , 1 , 1 , 1 , 1 , 1,  1 , 1 , 1 , 1 , 1 , 70, 
                         70, 1 , 1 , 1 , 1 , 1 , 1 , 1 , 1 , 1,  1 , 1 , 1 , 1 , 1 , 70, 
                         70, 1 , 1 , 1 , 1 , 1 , 1 , 1 , 1 , 1,  1 , 1 , 1 , 1 , 1 , 70, 
                         70, 70, 70, 70, 70, 70, 70, 70, 70, 70, 70, 70, 70, 70, 70, 70],
        "logical_grid": [1, 1, 1, 1, 1, 1, 1, 1, 1, 1, 1, 1, 1, 1, 1, 1,
                         1, 0, 0, 2, 3, 4, 0, 0, 0, 0, 0, 0, 0, 0, 0, 1, 
                         1, 0, 0, 0, 0, 3, 4, 0, 0, 0, 0, 0, 0, 0, 0, 1, 
                         1, 0, 0, 0, 0, 0, 0, 0, 0, 0, 0, 0, 0, 0, 0, 1, 
                         1, 0, 0, 0, 0, 0, 0, 0, 0, 0, 0, 0, 0, 0, 0, 1, 
                         1, 1, 1, 1, 1, 1, 1, 1, 1, 1, 1, 1, 1, 1, 1, 1]
    }
}